专	專
业	業
丛	叢
东	東
丝	絲
丢	丟
两	兩
严	嚴
丧	喪
个	個
临	臨
丽	麗
举	舉
义	義
乌	烏
乐	樂
乔	喬
习	習
乡	鄉
书	書
买	買
乱	亂
争	爭
亏	虧
亚	亞
亘	亙
亩	畝
亲	親
亵	褻
亸	嚲
亿	億
仅	僅
从	從
仑	侖
仓	倉
仪	儀
们	們
优	優
会	會
伛	傴
伞	傘
伟	偉
传	傳
伣	俔
伤	傷
伥	倀
伦	倫
伧	傖
伫	佇
佥	僉
侠	俠
侣	侶
侥	僥
侦	偵
侧	側
侨	僑
侩	儈
侪	儕
侬	儂
俣	俁
俦	儔
俨	儼
俩	倆
俪	儷
俫	倈
俭	儉
债	債
倾	傾
偬	傯
偻	僂
偾	僨
偿	償
傥	儻
傧	儐
储	儲
傩	儺
兑	兌
兖	兗
兰	蘭
关	關
兴	興
兹	茲
养	養
兽	獸
冁	囅
内	內
冈	岡
册	冊
写	寫
军	軍
农	農
冯	馮
决	決
况	況
冻	凍
净	淨
凉	涼
减	減
凄	淒
凑	湊
凛	凜
凤	鳳
凯	凱
击	擊
凿	鑿
刍	芻
刘	劉
则	則
刚	剛
创	創
删	刪
刬	剗
刭	剄
刹	剎
刽	劊
刿	劌
剀	剴
剂	劑
剐	剮
剑	劍
剥	剝
剧	劇
劝	勸
办	辦
务	務
劢	勱
动	動
励	勵
劲	勁
劳	勞
势	勢
勋	勳
勚	勩
匀	勻
匦	匭
匮	匱
区	區
医	醫
华	華
协	協
单	單
卖	賣
卢	盧
卫	衛
却	卻
厅	廳
厉	厲
压	壓
厌	厭
厍	厙
厐	龎
厘	釐
厢	廂
厣	厴
厦	廈
厨	廚
厩	廄
厮	廝
县	縣
叁	叄
参	參
双	雙
变	變
叙	敘
叠	疊
号	號
叹	歎
叽	嘰
吓	嚇
吕	呂
吗	嗎
吣	唚
吨	噸
听	聽
吴	吳
呐	吶
呒	嘸
呓	囈
呕	嘔
呖	嚦
呗	唄
员	員
呙	咼
呛	嗆
呜	嗚
咏	詠
咙	嚨
咛	嚀
咝	噝
响	響
哑	啞
哒	噠
哓	嘵
哔	嗶
哕	噦
哗	嘩
哙	噲
哜	嚌
哝	噥
哟	喲
唛	嘜
唝	嗊
唠	嘮
唡	啢
唢	嗩
唤	喚
啧	嘖
啬	嗇
啭	囀
啮	齧
啴	嘽
啸	嘯
㖞	喎
喷	噴
喽	嘍
啰	囉
喾	嚳
嗫	囁
嗳	噯
嘘	噓
嘤	嚶
嘱	囑
噜	嚕
嚣	囂
园	園
囱	囪
围	圍
囵	圇
国	國
图	圖
圆	圓
圣	聖
圹	壙
场	場
坂	阪
块	塊
坚	堅
坜	壢
坝	壩
坞	塢
坟	墳
坠	墜
垄	壟
垅	壠
垆	壚
垒	壘
垦	墾
垩	堊
垫	墊
垭	埡
垱	壋
垲	塏
垴	堖
埘	塒
埙	壎
埚	堝
埯	垵
堑	塹
堕	墮
𡒄	壈
壮	壯
声	聲
壶	壺
壸	壼
处	處
备	備
够	夠
头	頭
夹	夾
夺	奪
奁	奩
奂	奐
奋	奮
奥	奧
妆	妝
妇	婦
妈	媽
妩	嫵
妪	嫗
姗	姍
姹	奼
娄	婁
娅	婭
娆	嬈
娇	嬌
娈	孌
娱	娛
娲	媧
娴	嫺
婳	嫿
婴	嬰
婵	嬋
婶	嬸
媪	媼
嫒	嬡
嫔	嬪
嫱	嬙
嬷	嬤
孙	孫
学	學
孪	孿
宝	寶
实	實
宠	寵
审	審
宪	憲
宫	宮
宽	寬
宾	賓
寝	寢
对	對
寻	尋
导	導
寿	壽
将	將
尔	爾
尘	塵
尝	嘗
尧	堯
尴	尷
尸	屍
层	層
屃	屭
屉	屜
届	屆
属	屬
屡	屢
屦	屨
屿	嶼
岁	歲
岂	豈
岖	嶇
岗	崗
岘	峴
岙	嶴
岚	嵐
岛	島
岭	嶺
岽	崬
岿	巋
峄	嶧
峡	峽
峣	嶢
峤	嶠
峥	崢
峦	巒
崂	嶗
崃	崍
崄	嶮
崭	嶄
嵘	嶸
嵚	嶔
嵝	嶁
巅	巔
巩	鞏
巯	巰
币	幣
帅	帥
师	師
帏	幃
帐	帳
帜	幟
带	帶
帧	幀
帮	幫
帱	幬
帻	幘
帼	幗
幂	冪
幺	么
庄	莊
庆	慶
庐	廬
庑	廡
库	庫
应	應
庙	廟
庞	龐
废	廢
廪	廩
开	開
异	異
弃	棄
弑	弒
张	張
弪	弳
弯	彎
弹	彈
强	強
归	歸
彝	彞
彦	彥
彻	徹
径	徑
徕	徠
忆	憶
忏	懺
忧	憂
忾	愾
怀	懷
态	態
怂	慫
怃	憮
怄	慪
怅	悵
怆	愴
怜	憐
总	總
怼	懟
怿	懌
恋	戀
恒	恆
恳	懇
恸	慟
恹	懨
恺	愷
恻	惻
恼	惱
恽	惲
悦	悅
悬	懸
悭	慳
悮	悞
悯	憫
惊	驚
惧	懼
惨	慘
惩	懲
惫	憊
惬	愜
惭	慚
惮	憚
惯	慣
愠	慍
愤	憤
愦	憒
慑	懾
懑	懣
懒	懶
懔	懍
戆	戇
戋	戔
戏	戲
戗	戧
战	戰
戬	戩
戯	戱
户	戶
扑	撲
执	執
扩	擴
扪	捫
扫	掃
扬	揚
扰	擾
抚	撫
抛	拋
抟	摶
抠	摳
抡	掄
抢	搶
护	護
报	報
拟	擬
拢	攏
拣	揀
拥	擁
拦	攔
拧	擰
拨	撥
择	擇
挂	掛
挚	摯
挛	攣
挜	掗
挝	撾
挞	撻
挟	挾
挠	撓
挡	擋
挢	撟
挣	掙
挤	擠
挥	揮
挦	撏
捝	挩
捞	撈
损	損
捡	撿
换	換
捣	搗
掳	擄
掴	摑
掷	擲
掸	撣
掺	摻
掼	摜
揽	攬
揾	搵
揿	撳
搀	攙
搁	擱
搂	摟
搅	攪
携	攜
摄	攝
摅	攄
摆	擺
摇	搖
摈	擯
摊	攤
撄	攖
撑	撐
㧑	撝
撵	攆
撷	擷
撸	擼
撺	攛
㧟	擓
擞	擻
攒	攢
敌	敵
敛	斂
数	數
斋	齋
斓	斕
斩	斬
断	斷
无	無
旧	舊
时	時
旷	曠
旸	暘
昙	曇
昼	晝
昽	曨
显	顯
晋	晉
晒	曬
晓	曉
晔	曄
晕	暈
晖	暉
暂	暫
暧	曖
昵	暱
机	機
杀	殺
杂	雜
权	權
杆	桿
条	條
来	來
杨	楊
杩	榪
杰	傑
构	構
枞	樅
枢	樞
枣	棗
枥	櫪
枧	梘
枨	棖
枪	槍
枫	楓
枭	梟
柠	檸
柽	檉
栀	梔
栅	柵
标	標
栈	棧
栉	櫛
栊	櫳
栋	棟
栌	櫨
栎	櫟
栏	欄
树	樹
栖	棲
样	樣
栾	欒
桠	椏
桡	橈
桢	楨
档	檔
桤	榿
桥	橋
桦	樺
桧	檜
桨	槳
桩	樁
梦	夢
梼	檮
梾	棶
梿	槤
检	檢
棁	梲
棂	欞
椁	槨
椟	櫝
椠	槧
椤	欏
椭	橢
楼	樓
榄	欖
棱	稜
榅	榲
榇	櫬
榈	櫚
榉	櫸
槚	檟
槛	檻
檐	簷
槟	檳
槠	櫧
横	橫
樯	檣
樱	櫻
橥	櫫
橱	櫥
橹	櫓
橼	櫞
檩	檁
欢	歡
欤	歟
欧	歐
歼	殲
殁	歿
殇	殤
残	殘
殒	殞
殓	殮
殚	殫
殡	殯
㱮	殨
殴	毆
毁	毀
毂	轂
毕	畢
毙	斃
毡	氈
毵	毿
氇	氌
气	氣
氢	氫
氩	氬
氲	氳
汉	漢
汤	湯
汹	洶
沟	溝
没	沒
沣	灃
沤	漚
沥	瀝
沦	淪
沧	滄
沪	滬
泞	濘
泪	淚
泶	澩
泷	瀧
泸	瀘
泺	濼
泻	瀉
泼	潑
泽	澤
泾	涇
涌	湧
洁	潔
洒	灑
洼	窪
浃	浹
浅	淺
浆	漿
浇	澆
浈	湞
浊	濁
测	測
浍	澮
济	濟
浏	瀏
浐	滻
浑	渾
浒	滸
浓	濃
浔	潯
涛	濤
涝	澇
涞	淶
涟	漣
涠	潿
涡	渦
涣	渙
涤	滌
润	潤
涧	澗
涨	漲
涩	澀
渊	淵
渌	淥
渍	漬
渎	瀆
渐	漸
渑	澠
渔	漁
渖	瀋
渗	滲
温	溫
湾	灣
湿	濕
溃	潰
溅	濺
溆	漵
滗	潷
滚	滾
滞	滯
滟	灧
滠	灄
满	滿
滢	瀅
滤	濾
滥	濫
羡	羨
滦	灤
滨	濱
滩	灘
滪	澦
漤	灠
潆	瀠
潇	瀟
潋	瀲
潍	濰
潜	潛
潴	瀦
澜	瀾
濑	瀨
濒	瀕
灏	灝
灭	滅
灯	燈
灵	靈
灾	災
灿	燦
炀	煬
炉	爐
炖	燉
炜	煒
炝	熗
点	點
炼	煉
炽	熾
烁	爍
烂	爛
烃	烴
烛	燭
烟	煙
烦	煩
烧	燒
烨	燁
烩	燴
烫	燙
烬	燼
热	熱
焕	煥
焖	燜
焘	燾
煴	熅
爱	愛
爷	爺
牍	牘
牦	氂
牵	牽
牺	犧
犊	犢
状	狀
犷	獷
犸	獁
犹	猶
狈	狽
狝	獮
狞	獰
独	獨
狭	狹
狮	獅
狯	獪
狰	猙
狱	獄
狲	猻
猃	獫
猎	獵
猕	獼
猡	玀
猪	豬
猫	貓
猬	蝟
献	獻
獭	獺
玑	璣
玚	瑒
玛	瑪
玮	瑋
环	環
现	現
玱	瑲
玺	璽
珐	琺
珑	瓏
珰	璫
珲	琿
琏	璉
琐	瑣
琼	瓊
瑶	瑤
瑷	璦
璎	瓔
瓒	瓚
瓯	甌
电	電
画	畫
畅	暢
畴	疇
疖	癤
疗	療
疟	瘧
疠	癘
疡	瘍
疬	癧
疭	瘲
疮	瘡
疯	瘋
疱	皰
疴	痾
痈	癰
痉	痙
痒	癢
痖	瘂
痨	癆
痪	瘓
痫	癇
瘅	癉
瘆	瘮
瘗	瘞
瘪	癟
瘫	癱
瘾	癮
瘿	癭
癞	癩
癣	癬
癫	癲
皑	皚
皱	皺
皲	皸
盏	盞
盐	鹽
监	監
盖	蓋
盗	盜
盘	盤
眍	瞘
眦	眥
眬	矓
着	著
睁	睜
睐	睞
睑	瞼
瞆	瞶
瞒	瞞
䁖	瞜
瞩	矚
矫	矯
矶	磯
矾	礬
矿	礦
砀	碭
码	碼
砖	磚
砗	硨
砚	硯
砜	碸
砺	礪
砻	礱
砾	礫
础	礎
硁	硜
硕	碩
硖	硤
硗	磽
硙	磑
碍	礙
碛	磧
碜	磣
碱	鹼
礼	禮
祃	禡
祎	禕
祢	禰
祯	禎
祷	禱
祸	禍
禀	稟
禄	祿
禅	禪
离	離
秃	禿
秆	稈
积	積
称	稱
秽	穢
秾	穠
稆	穭
税	稅
稣	穌
稳	穩
穑	穡
穷	窮
窃	竊
窍	竅
窎	窵
窑	窯
窜	竄
窝	窩
窥	窺
窦	竇
窭	窶
竞	競
笃	篤
笋	筍
笔	筆
笕	筧
笺	箋
笼	籠
笾	籩
筚	篳
筛	篩
筜	簹
筝	箏
䇲	筴
筹	籌
筼	篔
简	簡
箓	籙
箦	簀
箧	篋
箨	籜
箩	籮
箪	簞
箫	簫
篑	簣
篓	簍
篮	籃
篱	籬
簖	籪
籁	籟
籴	糴
类	類
籼	秈
粜	糶
粝	糲
粤	粵
粪	糞
粮	糧
糁	糝
糇	餱
紧	緊
䌷	紬
䌹	絅
絷	縶
䌸	縳
䍁	繸
纟	糹
纠	糾
纡	紆
红	紅
纣	紂
纥	紇
约	約
级	級
纨	紈
纩	纊
纪	紀
纫	紉
䌶	䊷
纬	緯
纭	紜
纮	紘
纯	純
纰	紕
纱	紗
纲	綱
纳	納
纴	紝
纵	縱
纶	綸
纷	紛
纸	紙
纹	紋
纺	紡
纻	紵
纼	紖
纽	紐
纾	紓
绀	紺
绁	絏
绂	紱
练	練
组	組
绅	紳
细	細
织	織
终	終
绉	縐
绊	絆
绋	紼
绌	絀
绍	紹
绎	繹
经	經
绐	紿
绑	綁
绒	絨
结	結
绔	絝
绕	繞
绖	絰
绗	絎
绘	繪
给	給
绚	絢
绛	絳
络	絡
绞	絞
统	統
绠	綆
绡	綃
绢	絹
绤	綌
绥	綏
继	繼
绨	綈
绩	績
绪	緒
绫	綾
绬	緓
续	續
绮	綺
绯	緋
绰	綽
绲	緄
绳	繩
维	維
绵	綿
绶	綬
绸	綢
绹	綯
绺	綹
绻	綣
综	綜
绽	綻
绾	綰
缀	綴
缁	緇
缂	緙
缃	緗
缄	緘
缅	緬
缆	纜
缇	緹
缈	緲
缉	緝
缊	縕
缋	繢
缌	緦
缍	綞
缎	緞
缏	緶
缑	緱
缒	縋
缓	緩
缔	締
缕	縷
编	編
缗	緡
缘	緣
缙	縉
缚	縛
缛	縟
缜	縝
缝	縫
缞	縗
缟	縞
缠	纏
缡	縭
缢	縊
缣	縑
缤	繽
缥	縹
缦	縵
缧	縲
缨	纓
缩	縮
缪	繆
缫	繅
缬	纈
缭	繚
缮	繕
缯	繒
缱	繾
缲	繰
缳	繯
缴	繳
缵	纘
罂	罌
网	網
罗	羅
罚	罰
罢	罷
罴	羆
羁	覊
羟	羥
翘	翹
耢	耮
耧	耬
耸	聳
耻	恥
聂	聶
聋	聾
职	職
聍	聹
联	聯
聩	聵
聪	聰
肃	肅
肠	腸
肤	膚
肮	骯
肴	餚
肾	腎
肿	腫
胀	脹
胁	脅
胆	膽
胧	朧
胨	腖
胪	臚
胫	脛
胶	膠
脉	脈
脍	膾
脐	臍
腘	膕
脑	腦
脓	膿
脔	臠
脚	腳
脱	脫
脶	腡
脸	臉
腭	齶
腻	膩
腼	靦
腽	膃
腾	騰
膑	臏
臜	臢
舆	輿
舣	艤
舰	艦
舱	艙
舻	艫
艰	艱
艳	艷
艺	藝
节	節
芈	羋
芗	薌
芜	蕪
芦	蘆
苁	蓯
苇	葦
苈	藶
苋	莧
苌	萇
苍	蒼
苎	苧
茎	莖
茏	蘢
茑	蔦
茔	塋
茕	煢
茧	繭
荆	荊
荐	薦
荙	薘
荚	莢
荛	蕘
荜	蓽
荞	蕎
荟	薈
荠	薺
荡	蕩
荣	榮
荤	葷
荥	滎
荦	犖
荧	熒
荨	蕁
荩	藎
荪	蓀
荫	蔭
荬	蕒
荭	葒
荮	葤
莅	蒞
莱	萊
莲	蓮
莳	蒔
莴	萵
莶	薟
莸	蕕
莹	瑩
莺	鶯
萝	蘿
萤	螢
营	營
萦	縈
萧	蕭
萨	薩
葱	蔥
蒇	蕆
蒉	蕢
蒋	蔣
蒌	蔞
蓝	藍
蓟	薊
蓠	蘺
蓣	蕷
蓥	鎣
蓦	驀
蔂	虆
蔷	薔
蔹	蘞
蔺	藺
蔼	藹
蕰	薀
蕲	蘄
薮	藪
藓	蘚
蘖	櫱
虏	虜
虑	慮
虚	虛
虬	虯
虮	蟣
虽	雖
虾	蝦
虿	蠆
蚀	蝕
蚁	蟻
蚂	螞
蚝	蠔
蚕	蠶
蚬	蜆
蛊	蠱
蛎	蠣
蛏	蟶
蛮	蠻
蛰	蟄
蛱	蛺
蛲	蟯
蛳	螄
蛴	蠐
蜕	蛻
蜗	蝸
蝇	蠅
蝈	蟈
蝉	蟬
蝼	螻
蝾	蠑
螀	螿
螨	蟎
蟏	蠨
衅	釁
衔	銜
补	補
衬	襯
衮	袞
袄	襖
袅	裊
袆	褘
袜	襪
袭	襲
袯	襏
装	裝
裆	襠
裈	褌
裢	褳
裣	襝
裤	褲
裥	襇
褛	褸
褴	襤
襕	襴
见	見
观	觀
觃	覎
规	規
觅	覓
视	視
觇	覘
览	覽
觉	覺
觊	覬
觋	覡
觌	覿
觍	覥
觎	覦
觏	覯
觐	覲
觑	覷
觞	觴
触	觸
觯	觶
訚	誾
䜣	訢
誉	譽
誊	謄
讠	訁
计	計
订	訂
讣	訃
认	認
讥	譏
讦	訐
讧	訌
讨	討
让	讓
讪	訕
讫	訖
讬	託
训	訓
议	議
讯	訊
记	記
讱	訒
讲	講
讳	諱
讴	謳
讵	詎
讶	訝
讷	訥
许	許
讹	訛
论	論
讻	訩
讼	訟
讽	諷
设	設
访	訪
诀	訣
证	證
诂	詁
诃	訶
评	評
诅	詛
识	識
诇	詗
诈	詐
诉	訴
诊	診
诋	詆
诌	謅
词	詞
诎	詘
诏	詔
诐	詖
译	譯
诒	詒
诓	誆
诔	誄
试	試
诖	詿
诗	詩
诘	詰
诙	詼
诚	誠
诛	誅
诜	詵
话	話
诞	誕
䜥	𧩙
诟	詬
诠	詮
诡	詭
询	詢
诣	詣
诤	諍
该	該
详	詳
诧	詫
诨	諢
诩	詡
诪	譸
诫	誡
诬	誣
语	語
诮	誚
误	誤
诰	誥
诱	誘
诲	誨
诳	誑
诵	誦
诶	誒
请	請
诸	諸
诹	諏
诺	諾
读	讀
诼	諑
诽	誹
课	課
诿	諉
谀	諛
谁	誰
谂	諗
调	調
谄	諂
谅	諒
谆	諄
谇	誶
谈	談
谊	誼
谋	謀
谌	諶
谍	諜
谎	謊
谏	諫
谐	諧
谑	謔
谒	謁
谓	謂
谔	諤
谕	諭
谖	諼
谗	讒
谘	諮
谙	諳
谚	諺
谛	諦
谜	謎
谝	諞
谞	諝
谟	謨
谠	讜
谡	謖
谢	謝
谤	謗
谥	諡
谦	謙
谧	謐
谨	謹
谩	謾
谪	謫
谬	謬
谭	譚
谮	譖
谯	譙
谰	讕
谱	譜
谲	譎
谳	讞
谴	譴
谵	譫
谶	讖
豮	豶
贝	貝
贞	貞
负	負
贠	貟
贡	貢
财	財
责	責
贤	賢
败	敗
账	賬
货	貨
质	質
贩	販
贪	貪
贫	貧
贬	貶
购	購
贮	貯
贯	貫
贰	貳
贱	賤
贲	賁
贳	貰
贴	貼
贵	貴
贶	貺
贷	貸
贸	貿
费	費
贺	賀
贻	貽
贼	賊
贽	贄
贾	賈
贿	賄
赀	貲
赁	賃
赂	賂
资	資
赅	賅
赆	贐
赇	賕
赈	賑
赉	賚
赊	賒
赋	賦
赌	賭
赎	贖
赏	賞
赐	賜
赑	贔
赒	賙
赓	賡
赔	賠
赕	賧
赖	賴
赗	賵
赘	贅
赙	賻
赚	賺
赛	賽
赜	賾
赞	贊
赟	贇
赠	贈
赡	贍
赢	贏
赣	贛
赪	赬
赵	趙
赶	趕
趋	趨
趱	趲
趸	躉
跃	躍
跄	蹌
跞	躒
践	踐
跶	躂
跷	蹺
跸	蹕
跹	躚
跻	躋
踊	踴
踌	躊
踪	蹤
踬	躓
踯	躑
蹑	躡
蹒	蹣
蹰	躕
蹿	躥
躏	躪
躜	躦
躯	軀
车	車
轧	軋
轨	軌
轩	軒
轪	軑
轫	軔
转	轉
轭	軛
轮	輪
软	軟
轰	轟
轱	軲
轲	軻
轳	轤
轴	軸
轵	軹
轶	軼
轷	軤
轸	軫
轹	轢
轺	軺
轻	輕
轼	軾
载	載
轾	輊
轿	轎
辀	輈
辁	輇
辂	輅
较	較
辄	輒
辅	輔
辆	輛
辇	輦
辈	輩
辉	輝
辊	輥
辋	輞
辌	輬
辍	輟
辎	輜
辏	輳
辐	輻
辑	輯
辒	轀
输	輸
辔	轡
辕	轅
辖	轄
辗	輾
辘	轆
辙	轍
辚	轔
辞	辭
辩	辯
辫	辮
边	邊
辽	遼
达	達
迁	遷
过	過
迈	邁
运	運
还	還
这	這
进	進
远	遠
违	違
连	連
迟	遲
迩	邇
迳	逕
迹	跡
选	選
逊	遜
递	遞
逦	邐
逻	邏
遗	遺
遥	遙
邓	鄧
邝	鄺
邬	鄔
邮	郵
邹	鄒
邺	鄴
邻	鄰
郏	郟
郐	鄶
郑	鄭
郓	鄆
郦	酈
郧	鄖
郸	鄲
酂	酇
酦	醱
酱	醬
酽	釅
酾	釃
酿	釀
腌	醃
獾	貛
释	釋
鉴	鑑
銮	鑾
錾	鏨
钅	釒
钆	釓
钇	釔
针	針
钉	釘
钊	釗
钋	釙
钌	釕
钍	釷
钎	釺
钏	釧
钐	釤
钑	鈒
钒	釩
钓	釣
钔	鍆
钕	釹
钖	鍚
钗	釵
钘	鈃
钙	鈣
钚	鈈
钛	鈦
钜	鉅
钝	鈍
钞	鈔
钠	鈉
钡	鋇
钢	鋼
钣	鈑
钤	鈐
钥	鑰
钦	欽
钧	鈞
钨	鎢
钪	鈧
钫	鈁
钬	鈥
钭	鈄
钮	鈕
钯	鈀
钰	鈺
钱	錢
钲	鉦
钳	鉗
钴	鈷
钶	鈳
钷	鉕
钸	鈽
钹	鈸
钺	鉞
钻	鑽
钼	鉬
钽	鉭
钾	鉀
钿	鈿
铀	鈾
铁	鐵
铂	鉑
铃	鈴
铄	鑠
铅	鉛
铆	鉚
铇	鉋
铈	鈰
铉	鉉
铊	鉈
铋	鉍
铌	鈮
铍	鈹
铎	鐸
铏	鉶
铐	銬
铑	銠
铒	鉺
铓	鋩
铔	錏
铕	銪
铖	鋮
铗	鋏
铘	鋣
铙	鐃
铚	銍
铛	鐺
铜	銅
铝	鋁
铞	銱
铟	銦
铠	鎧
铡	鍘
铢	銖
铣	銑
铤	鋌
铥	銩
铦	銛
铧	鏵
铨	銓
铩	鎩
铪	鉿
铫	銚
铬	鉻
铭	銘
铮	錚
铯	銫
铰	鉸
铱	銥
铲	鏟
铳	銃
铴	鐋
铵	銨
银	銀
铷	銣
铸	鑄
铹	鐒
铺	鋪
铻	鋙
铼	錸
铽	鋱
链	鏈
铿	鏗
销	銷
锁	鎖
锂	鋰
锃	鋥
锄	鋤
锅	鍋
锆	鋯
锇	鋨
锉	銼
锊	鋝
锋	鋒
锌	鋅
锍	鋶
锎	鐦
锏	鐧
锑	銻
锒	鋃
锓	鋟
锔	鋦
锕	錒
锖	錆
锗	鍺
锘	鍩
错	錯
锚	錨
锛	錛
锜	錡
锝	鍀
锞	錁
锟	錕
锠	錩
锡	錫
锢	錮
锣	鑼
锤	錘
锥	錐
锦	錦
锧	鑕
锩	錈
锪	鍃
锫	錇
锬	錟
锭	錠
键	鍵
锯	鋸
锰	錳
锱	錙
锲	鍥
锳	鍈
锴	鍇
锵	鏘
锶	鍶
锷	鍔
锸	鍤
锹	鍬
锺	鍾
锻	鍛
锼	鎪
锽	鍠
锾	鍰
锿	鎄
镀	鍍
镁	鎂
镂	鏤
镃	鎡
镄	鐨
镅	鎇
镆	鏌
镇	鎮
镈	鎛
镉	鎘
镊	鑷
镋	鎲
镍	鎳
镎	鎿
镏	鎦
镐	鎬
镑	鎊
镒	鎰
镓	鎵
镔	鑌
镕	鎔
镖	鏢
镗	鏜
镘	鏝
镙	鏍
镚	鏰
镛	鏞
镜	鏡
镝	鏑
镞	鏃
镟	鏇
镠	鏐
镡	鐔
镣	鐐
镤	鏷
镥	鑥
镦	鐓
镧	鑭
镨	鐠
镩	鑹
镪	鏹
镫	鐙
镬	鑊
镭	鐳
镮	鐶
镯	鐲
镰	鐮
镱	鐿
镲	鑔
镳	鑣
镴	鑞
镵	鑱
镶	鑲
长	長
门	門
闩	閂
闪	閃
闫	閆
闬	閈
闭	閉
问	問
闯	闖
闰	閏
闱	闈
闲	閒
闳	閎
间	間
闵	閔
闶	閌
闷	悶
闸	閘
闹	鬧
闺	閨
闻	聞
闼	闥
闽	閩
闾	閭
闿	闓
阀	閥
阁	閣
阂	閡
阃	閫
阄	鬮
阆	閬
阇	闍
阈	閾
阉	閹
阊	閶
阋	鬩
阌	閿
阍	閽
阎	閻
阏	閼
阐	闡
阑	闌
阒	闃
阓	闠
阔	闊
阕	闋
阖	闔
阗	闐
阘	闒
阙	闕
阚	闞
阛	闤
队	隊
阳	陽
阴	陰
阵	陣
阶	階
际	際
陆	陸
陇	隴
陈	陳
陉	陘
陕	陝
陧	隉
陨	隕
险	險
随	隨
隐	隱
隶	隸
隽	雋
难	難
雏	雛
雠	讎
雳	靂
雾	霧
霁	霽
霡	霢
霭	靄
靓	靚
静	靜
靥	靨
鞑	韃
鞒	鞽
鞯	韉
韦	韋
韧	韌
韨	韍
韩	韓
韪	韙
韫	韞
韬	韜
韵	韻
页	頁
顶	頂
顷	頃
顸	頇
项	項
顺	順
顼	頊
顽	頑
顾	顧
顿	頓
颀	頎
颁	頒
颂	頌
颃	頏
预	預
颅	顱
领	領
颇	頗
颈	頸
颉	頡
颊	頰
颋	頲
颌	頜
颍	潁
颎	熲
颏	頦
颐	頤
频	頻
颒	頮
颔	頷
颕	頴
颖	穎
颗	顆
题	題
颙	顒
颚	顎
颛	顓
额	額
颞	顳
颟	顢
颠	顛
颡	顙
颢	顥
颤	顫
颥	顬
颦	顰
颧	顴
风	風
飏	颺
飐	颭
飑	颮
飒	颯
飓	颶
飔	颸
飕	颼
飖	颻
飗	飀
飘	飄
飙	飆
飚	飈
飞	飛
飨	饗
餍	饜
饣	飠
饤	飣
饦	飥
饧	餳
饨	飩
饩	餼
饪	飪
饫	飫
饬	飭
饭	飯
饮	飲
饯	餞
饰	飾
饱	飽
饲	飼
饳	飿
饴	飴
饵	餌
饶	饒
饷	餉
饸	餄
饹	餎
饺	餃
饻	餏
饼	餅
饽	餑
饾	餖
饿	餓
馀	餘
馁	餒
馂	餕
馃	餜
馄	餛
馅	餡
馆	館
馇	餷
馈	饋
馉	餶
馊	餿
馋	饞
馌	饁
馍	饃
馎	餺
馏	餾
馐	饈
馑	饉
馒	饅
馓	饊
馔	饌
馕	饢
马	馬
驭	馭
驮	馱
驯	馴
驰	馳
驱	驅
驲	馹
驳	駁
驴	驢
驵	駔
驶	駛
驷	駟
驸	駙
驹	駒
驺	騶
驻	駐
驼	駝
驽	駑
驾	駕
驿	驛
骀	駘
骁	驍
骃	駰
骄	驕
骅	驊
骆	駱
骇	駭
骈	駢
骉	驫
骊	驪
骋	騁
验	驗
骍	騂
骎	駸
骏	駿
骐	騏
骑	騎
骒	騍
骓	騅
骔	騌
骕	驌
骖	驂
骗	騙
骘	騭
骙	騤
骚	騷
骛	騖
骜	驁
骝	騮
骞	騫
骟	騸
骠	驃
骡	騾
骢	驄
骣	驏
骤	驟
骥	驥
骦	驦
骧	驤
髅	髏
髋	髖
髌	髕
鬓	鬢
魇	魘
魉	魎
鱼	魚
鱽	魛
鱾	魢
鱿	魷
鲀	魨
鲁	魯
鲂	魴
鲃	䰾
鲄	魺
鲅	鮁
鲆	鮃
鲈	鱸
鲉	鮋
鲊	鮓
鲋	鮒
鲌	鮊
鲍	鮑
鲎	鱟
鲏	鮍
鲐	鮐
鲑	鮭
鲒	鮚
鲓	鮳
鲔	鮪
鲕	鮞
鲖	鮦
鲗	鰂
鲘	鮜
鲙	鱠
鲚	鱭
鲛	鮫
鲜	鮮
鲝	鮺
鲟	鱘
鲠	鯁
鲡	鱺
鲢	鰱
鲣	鰹
鲤	鯉
鲥	鰣
鲦	鰷
鲧	鯀
鲨	鯊
鲩	鯇
鲪	鮶
鲫	鯽
鲬	鯒
鲭	鯖
鲮	鯪
鲯	鯕
鲰	鯫
鲱	鯡
鲲	鯤
鲳	鯧
鲴	鯝
鲵	鯢
鲶	鯰
鲷	鯛
鲸	鯨
鲹	鰺
鲺	鯴
鲻	鯔
鲼	鱝
鲽	鰈
鲾	鰏
鲿	鱨
鳀	鯷
鳁	鰮
鳂	鰃
鳃	鰓
鳅	鰍
鳆	鰒
鳇	鰉
鳈	鰁
鳉	鱂
鳊	鯿
鳋	鰠
鳌	鰲
鳍	鰭
鳎	鰨
鳏	鰥
鳐	鰩
鳑	鰟
鳒	鰜
鳓	鰳
鳔	鰾
鳕	鱈
鳖	鱉
鳗	鰻
鳘	鰵
鳙	鱅
鳚	䲁
鳛	鰼
鳜	鱖
鳝	鱔
鳞	鱗
鳟	鱒
鳠	鱯
鳡	鱤
鳢	鱧
鳣	鱣
䴓	鳾
䴕	鴷
䴔	鵁
䴖	鶄
䴗	鶪
䴘	鷈
䴙	鷿
䴙	鸊
䴘	鷉
鸟	鳥
鸠	鳩
鸢	鳶
鸣	鳴
鸤	鳲
鸥	鷗
鸦	鴉
鸧	鶬
鸨	鴇
鸩	鴆
鸪	鴣
鸫	鶇
鸬	鸕
鸭	鴨
鸮	鴞
鸯	鴦
鸰	鴒
鸱	鴟
鸲	鴝
鸳	鴛
鸴	鷽
鸵	鴕
鸶	鷥
鸷	鷙
鸸	鴯
鸹	鴰
鸺	鵂
鸻	鴴
鸼	鵃
鸽	鴿
鸾	鸞
鸿	鴻
鹀	鵐
鹁	鵓
鹂	鸝
鹃	鵑
鹄	鵠
鹅	鵝
鹆	鵒
鹇	鷳
鹈	鵜
鹉	鵡
鹊	鵲
鹋	鶓
鹌	鵪
鹍	鵾
鹎	鵯
鹏	鵬
鹐	鵮
鹑	鶉
鹒	鶊
鹓	鵷
鹔	鷫
鹕	鶘
鹖	鶡
鹗	鶚
鹘	鶻
鹙	鶖
鹛	鶥
鹜	鶩
鹝	鷊
鹞	鷂
鹟	鶲
鹠	鶹
鹡	鶺
鹢	鷁
鹣	鶼
鹤	鶴
鹥	鷖
鹦	鸚
鹧	鷓
鹨	鷚
鹩	鷯
鹪	鷦
鹫	鷲
鹬	鷸
鹭	鷺
鹯	鸇
鹰	鷹
鹱	鸌
鹲	鸏
鹳	鸛
鹴	鸘
鹾	鹺
麦	麥
麸	麩
麽	麼
黄	黃
黉	黌
黡	黶
黩	黷
黪	黲
黾	黽
鼋	黿
鼍	鼉
鼗	鞀
鼹	鼴
齐	齊
齑	齏
齿	齒
龀	齔
龁	齕
龂	齗
龃	齟
龄	齡
龅	齙
龆	齠
龇	齜
龈	齦
龉	齬
龊	齪
龋	齲
龌	齷
龙	龍
龚	龔
龛	龕
龟	龜
万	萬
与	與
丑	醜
丰	豐
为	為
么	麼
于	於
云	雲
产	產
仆	僕
价	價
众	眾
伙	夥
伪	偽
体	體
余	餘
佣	傭
儿	兒
党	黨
冲	沖
准	準
几	幾
凫	鳧
凭	憑
划	劃
别	別
卤	滷
厂	廠
历	歷
厕	廁
发	發
叶	葉
吁	籲
后	後
启	啟
咸	鹹
团	團
坏	壞
坛	壇
墙	牆
壳	殼
复	復
奖	獎
妫	媯
宁	寧
尽	盡
帘	簾
干	乾
并	並
广	廣
弥	彌
当	當
录	錄
征	徵
恶	惡
悫	愨
愿	願
担	擔
据	據
斗	鬥
术	術
极	極
柜	櫃
汇	匯
沩	溈
涂	塗
淀	澱
瘘	瘻
确	確
硷	鹼
种	種
竖	豎
筑	築
签	簽
纤	纖
线	線
绝	絕
绣	繡
绦	絛
绱	緔
绷	繃
绿	綠
缰	韁
胜	勝
脏	臟
腊	臘
苏	蘇
苹	蘋
药	藥
获	獲
莼	蓴
蕴	蘊
虫	蟲
蜡	蠟
说	說
谣	謠
谫	譾
赃	贓
赍	齎
赝	贗
辟	闢
适	適
酝	醞
采	採
钟	鐘
钩	鉤
钵	缽
锈	鏽
锐	銳
锨	杴
镌	鐫
镢	钁
阅	閱
须	須
颓	頹
颜	顏
饥	飢
骂	罵
鲇	鯰
鲞	鯗
鳄	鱷
鸡	雞
鹚	鶿
瓮	甕
叆	靉
叇	靆
眯	瞇
琅	瑯
痴	癡
卧	臥
杠	槓
虱	蝨
唇	脣
狍	麅
泄	洩
捂	摀
翚	翬
雇	僱
侄	姪
膻	羶
痹	痺
坣	壆
恿	慂
玙	璵
伡	俥
䲞	𩶘
彟	彠
䜩	讌
僵尸	殭屍
一夥	一伙
一並	一併
一準	一准
一劃	一划
一地里	一地裡
一乾	一干
一樹百獲	一樹百穫
一沖	一衝
一只	一隻
一發千鈞	一髮千鈞
一出	一齣
七只	七隻
三元里	三元裡
三国志	三國誌
三復	三複
三只	三隻
萬俟	万俟
不準	不准
不乾	不幹
不舍	不捨
不知所雲	不知所云
不鏽钢	不鏽鋼
不寒而栗	不寒而慄
寒栗	寒慄
戰栗	戰慄
顫栗	顫慄
惴栗	惴慄
醜劇	丑劇
醜旦	丑旦
醜角	丑角
世界杯	世界盃
中岳	中嶽
豐南	丰南
豐姿	丰姿
豐神俊朗	丰神俊朗
豐採	丰采
豐韻	丰韻
主乾	主幹
九世之雠	九世之讎
九只	九隻
乾丝	乾絲
乾面	乾麵
亂發	亂髮
雲雲	云云
雲何	云何
雲爾	云爾
五岳	五嶽
五鬥櫃	五斗櫃
五鬥橱	五斗櫥
五鬥米	五斗米
五谷	五穀
五行生克	五行生剋
五只	五隻
五出	五齣
井里	井裡
交游	交遊
人雲亦雲	人云亦云
人物志	人物誌
什錦面	什錦麵
僕倒	仆倒
仇雠	仇讎
介系詞	介係詞
介係詞	介繫詞
仿制	仿製
仿佛	彷彿
夥伕	伙伕
夥伴	伙伴
夥同	伙同
夥夫	伙夫
夥房	伙房
夥計	伙計
夥食	伙食
伴游	伴遊
布下	佈下
布告	佈告
布哨	佈哨
布局	佈局
布崗	佈崗
布施	佈施
布景	佈景
布有	佈有
布滿	佈滿
布線	佈線
布置	佈置
布署	佈署
布道	佈道
布達	佈達
布防	佈防
布陣	佈陣
布雷	佈雷
體育锻鍊	体育鍛鍊
何乾	何干
作準	作准
作奸犯科	作姦犯科
傭人	佣人
傭工	佣工
傭金	佣金
並入	併入
並到	併到
並合	併合
並吞	併吞
並攏	併攏
並案	併案
並發	併發
並科	併科
並購	併購
並進	併進
來復	來複
供制	供製
侵並	侵併
系數	係數
系為	係為
保险櫃	保險柜
修复	修複
修胡刀	修鬍刀
俯沖	俯衝
個里	個裡
倦游	倦遊
偃僕	偃仆
假發	假髮
停制	停製
備注	備註
家夥	傢伙
家俱	傢俱
家具	傢具
傳布	傳佈
傻里傻氣	傻裡傻氣
傾復	傾覆
僱傭	僱佣
儀表	儀錶
億只	億隻
盡盡	儘儘
盡先	儘先
盡其所有	儘其所有
盡可能	儘可能
盡快	儘快
盡早	儘早
盡是	儘是
盡管	儘管
盡速	儘速
盡量	儘量
優游	優遊
允準	允准
光採	光采
克里	克裡
克復	克複
入夥	入伙
內制	內製
兩只	兩隻
屍位素餐	尸位素餐
行屍走肉	行尸走肉
八字胡	八字鬍
八只	八隻
公布	公佈
公乾	公幹
公鬥	公斗
公歷	公曆
公里	公裡
六谷	六穀
六只	六隻
六出	六齣
兼並	兼併
冤雠	冤讎
冶游	冶遊
準予	准予
準假	准假
準定	准定
準將	准將
準尉	准尉
準此	准此
準考證	准考證
準許	准許
幾幾	几几
幾杖	几杖
幾案	几案
幾筵	几筵
幾絲	几絲
凹洞里	凹洞裡
出徵	出征
出游	出遊
函復	函覆
刀削面	刀削麵
刁鬥	刁斗
分布	分佈
切面	切麵
刊布	刊佈
劃上	划上
劃下	划下
劃不來	划不來
劃了	划了
劃具	划具
劃出	划出
劃到	划到
劃動	划動
劃去	划去
劃子	划子
劃得來	划得來
劃拳	划拳
劃槳	划槳
劃水	划水
劃算	划算
劃船	划船
劃艇	划艇
劃著	划著
劃著走	划著走
劃行	划行
劃走	划走
劃起	划起
劃進	划進
劃過	划過
初徵	初征
別致	別緻
別只	別隻
利比里亞	利比裡亞
刮胡刀	刮鬍刀
剃發	剃髮
剃須	剃鬚
削發	削髮
克制	剋制
克扣	剋扣
克日	剋日
克星	剋星
克服	剋服
克期	剋期
克死	剋死
克薄	剋薄
前僕後仰	前仆後仰
前僕後繼	前仆後繼
前車之復	前車之覆
刚才	剛纔
剝制	剝製
剪發	剪髮
割舍	割捨
創獲	創穫
創制	創製
力爭上游	力爭上遊
加里寧	加裡寧
加注	加註
勞力士表	勞力士錶
包準	包准
包谷	包穀
匏系	匏繫
北岳	北嶽
北鬥	北斗
北回	北迴
匡復	匡複
匪乾	匪幹
十乾	十干
十只	十隻
十出	十齣
千百只	千百隻
千丝萬缕	千絲萬縷
千回百折	千迴百折
千回百转	千迴百轉
千鈞一發	千鈞一髮
千只	千隻
升鬥小民	升斗小民
半只	半隻
南岳	南嶽
南徵	南征
南鬥	南斗
南回	南迴
南游	南遊
卡里	卡裡
印制	印製
厚朴	厚樸
反沖	反衝
取舍	取捨
口里	口裡
只準	只准
只沖	只衝
叮當	叮噹
可怜蟲	可憐虫
可緊可松	可緊可鬆
喂食	餵食
喂奶	餵奶
喂養	餵養
喂哺	餵哺
籲籲	吁吁
籲氣	吁氣
吃里扒外	吃裡扒外
吃里爬外	吃裡爬外
合夥	合伙
合並	合併
同夥	同伙
名表	名錶
後冠	后冠
後北街	后北街
後土	后土
後妃	后妃
後安路	后安路
後平路	后平路
後座	后座
後稷	后稷
後羿	后羿
後街	后街
後里	后里
吞並	吞併
吟游	吟遊
吹發	吹髮
吕後	呂后
呆里呆氣	呆裡呆氣
呈準	呈准
周游	週遊
周期	週期
周末	週末
周年	週年
周身	週身
周刊	週刊
周知	週知
周日	週日
周息	週息
周報	週報
周遊	週遊
周會	週會
周一	週一
周二	週二
周三	週三
周四	週四
周五	週五
周六	週六
下周	下週
上周	上週
眾所周知	眾所週知
周而復始	週而復始
繞行一周	繞行一週
和奸	和姦
和面	和麵
哪里	哪裡
哭臟	哭髒
品嘗	品嚐
嘗鮮	嚐鮮
嘗嘗鮮	嚐嚐鮮
唱游	唱遊
喝採	喝采
喬岳	喬嶽
單乾	單干
彩帶	綵帶
剪彩	剪綵
念书	唸書
默念	默唸
念白	唸白
念经	唸經
念佛	唸佛
念咒	唸咒
念念有词	唸唸有詞
吃斋念佛	吃齋唸佛
一人吃斋十人念佛	一人吃齋十人唸佛
單只	單隻
嘴里	嘴裡
惡心	噁心
當啷	噹啷
當當	噹噹
嚕蘇	嚕囌
咽气	嚥氣
咽口水	嚥口水
狼吞虎咽	狼吞虎嚥
细嚼慢咽	細嚼慢嚥
向導	嚮導
向往	嚮往
向應	嚮應
向邇	嚮邇
向日葵	嚮日葵
严丝合缝	嚴絲合縫
囉蘇	囉囌
四舍五入	四捨五入
四只	四隻
四出	四齣
回歷新年	回曆新年
回丝	回絲
回復	回覆
回游	回遊
回採	回采
圈子里	圈子裡
圈里	圈裡
國歷	國曆
国雠	國讎
園里	園裡
園游會	園遊會
圖里	圖裡
占有	佔有
占據	佔據
占上風	佔上風
占下風	佔下風
占多數	佔多數
占少數	佔少數
占便宜	佔便宜
占著	佔著
占了	佔了
占優勢	佔優勢
侵占	侵佔
獨占	獨佔
土里	土裡
土制	土製
地志	地誌
坑里	坑裡
垂發	垂髮
埃及豔後	埃及豔后
埃榮沖	埃榮衝
埋布	埋佈
城里	城裡
基乾	基幹
墓志	墓誌
墨鬥	墨斗
墨沈未乾	墨瀋未乾
墨索里尼	墨索裡尼
垦復	墾複
垄断價格	壟斷價格
垄断资產	壟斷資產
垄断集團	壟斷集團
壯游	壯遊
壺里	壺裡
壽面	壽麵
凶惡	兇惡
凶殘	兇殘
凶神	兇神
凶手	兇手
凶狠	兇狠
凶暴	兇暴
凶猛	兇猛
凶徒	兇徒
凶悍	兇悍
凶氣	兇氣
凶器	兇器
凶嫌	兇嫌
凶險	兇險
凶殺	兇殺
凶煞	兇煞
凶案	兇案
幫凶	幫兇
元凶	元兇
行凶	行兇
很凶	很兇
緝凶	緝兇
凶巴巴	兇巴巴
凶相畢露	兇相畢露
窮凶極惡	窮兇極惡
真凶實犯	真兇實犯
夏天里	夏天裡
夏歷	夏曆
外制	外製
多沖	多衝
多採多姿	多采多姿
夜光表	夜光錶
夜里	夜裡
夜游	夜遊
夢里	夢裡
夢游	夢遊
大夥	大伙
大乾	大幹
大夸	大誇
大只	大隻
天後	天后
天乾	天干
天翻地復	天翻地覆
太後	太后
奏折	奏摺
女醜	女丑
女傭	女佣
好家夥	好傢夥
好困	好睏
姜丝	姜絲
奸夫	姦夫
奸婦	姦婦
奸宄	姦宄
奸情	姦情
奸殺	姦殺
奸污	姦汙
奸污	姦污
奸淫	姦淫
奸猾	姦猾
奸邪	姦邪
嬉游	嬉遊
字匯	字彙
字里行間	字裡行間
存折	存摺
宇宙志	宇宙誌
安沈铁路	安瀋鐵路
定準	定准
定制	定製
宣布	宣佈
宦游	宦遊
宫里	宮裡
宴游	宴遊
家夥	家伙
家里	家裡
密布	密佈
密致	密緻
寇雠	寇讎
實乾	實幹
寬松	寬鬆
寶里寶氣	寶裡寶氣
封後	封后
封面里	封面裡
射乾	射干
专注	專註
對表	對錶
導游	導遊
小醜	小丑
小夥	小伙
小只	小隻
就里	就裡
尺布鬥粟	尺布斗粟
尼採	尼采
尿鬥	尿斗
局里	局裡
居里	居裡
屋子里	屋子裡
屋里	屋裡
展布	展佈
屢僕屢起	屢仆屢起
屯里	屯裡
山岳	山嶽
山鬥	山斗
山里	山裡
山重水復	山重水複
岱岳	岱嶽
峰回	峰迴
岳岳	嶽嶽
巔復	巔覆
巡回	巡迴
巡游	巡遊
巧乾	巧幹
巴爾乾	巴爾幹
巷里	巷裡
市里	市裡
布谷	布穀
簾布	帘布
带團参加	帶團參加
帶發修行	帶髮修行
乾世	干世
乾休	干休
乾系	干係
乾冒	干冒
乾卿何事	干卿何事
乾卿底事	干卿底事
乾城	干城
乾將	干將
乾德道	干德道
乾戈	干戈
乾撓	干撓
乾擾	干擾
乾支	干支
乾政	干政
乾時	干時
乾沒	干沒
乾涉	干涉
乾犯	干犯
乾祿	干祿
乾與	干與
乾諾道中	干諾道中
乾諾道西	干諾道西
乾謁	干謁
乾證	干證
乾譽	干譽
乾貝	干貝
乾連	干連
乾雲蔽日	干雲蔽日
乾預	干預
年歷	年曆
年里	年裡
並力	併力
並吞	併吞
並日而食	并日而食
乾上	幹上
乾下去	幹下去
乾不了	幹不了
乾不成	幹不成
乾了	幹了
乾事	幹事
乾些	幹些
乾個	幹個
乾勁	幹勁
乾員	幹員
乾啥	幹啥
乾嗎	幹嗎
乾嘛	幹嘛
乾壞事	幹壞事
乾完	幹完
乾將	幹將
乾得	幹得
乾性油	幹性油
乾才	幹才
乾掉	幹掉
乾校	幹校
乾活	幹活
乾流	幹流
乾球溫度	幹球溫度
乾略	幹略
乾線	幹線
乾練	幹練
乾警	幹警
乾起來	幹起來
乾路	幹路
乾辦	幹辦
乾這一行	幹這一行
乾這種事	幹這種事
乾道	幹道
乾部	幹部
乾麼	幹麼
幾丝	幾絲
幾只	幾隻
幾出	幾齣
底里	底裡
店里	店裡
康採恩	康采恩
廟里	廟裡
弄臟	弄髒
弘歷	弘曆
強奸	強姦
強乾弱枝	強幹弱枝
別扭	彆扭
別拗	彆拗
別氣	彆氣
別腳	彆腳
別著	彆著
弹藥	彈葯
匯刊	彙刊
匯報	彙報
匯整	彙整
匯算	彙算
匯編	彙編
匯總	彙總
匯纂	彙纂
匯輯	彙輯
匯集	彙集
形單影只	形單影隻
影後	影后
往里	往裡
徵伐	征伐
徵利	征利
徵塵	征塵
徵夫	征夫
徵屬	征屬
徵帆	征帆
徵戌	征戌
徵戰	征戰
徵收	征收
徵服	征服
徵求	征求
徵發	征發
徵衣	征衣
徵討	征討
徵途	征途
從里到外	從裡到外
從里向外	從裡向外
復雠	復讎
德乾高原	德干高原
心里	心裡
忙里	忙裡
快乾	快幹
快沖	快衝
急沖而下	急衝而下
怪里怪氣	怪裡怪氣
恩準	恩准
息交絕游	息交絕遊
悠游	悠遊
情有所鐘	情有所鍾
情有獨鐘	情有獨鍾
意面	意麵
慌里慌張	慌裡慌張
慰借	慰藉
憑借	憑藉
憑虚御风	憑虛御風
蒙懂	懞懂
怀里	懷裡
懷表	懷錶
戴表	戴錶
戽鬥	戽斗
房里	房裡
手折	手摺
手里	手裡
手表	手錶
手松	手鬆
才乾	才幹
才高八鬥	才高八斗
打谷	打穀
扞御	扞禦
批準	批准
批復	批覆
批注	批註
承制	承製
抓奸	抓姦
抗御	抗禦
折沖	折衝
披復	披覆
披發	披髮
抱朴	抱樸
抵御	抵禦
拆夥	拆伙
拈須	拈鬚
拉纖	拉縴
拉面	拉麵
拗別	拗彆
拮據	拮据
十沈	拾瀋
捉奸	捉姦
捍御	捍禦
舍不得	捨不得
舍出	捨出
舍去	捨去
舍命	捨命
舍己從人	捨己從人
舍己救人	捨己救人
舍己為人	捨己為人
舍己為公	捨己為公
舍己為國	捨己為國
舍得	捨得
舍我其誰	捨我其誰
舍本逐末	捨本逐末
舍棄	捨棄
舍死忘生	捨死忘生
舍生	捨生
舍短取長	捨短取長
舍身	捨身
舍車保帥	捨車保帥
舍近求遠	捨近求遠
卷發	捲髮
捵面	捵麵
排骨面	排骨麵
挂簾	掛帘
掛面	掛麵
換只	換隻
換發	換髮
握發	握髮
搭夥	搭伙
折合	摺合
折奏	摺奏
折子	摺子
折尺	摺尺
折扇	摺扇
折梯	摺梯
折椅	摺椅
折疊	摺疊
折痕	摺痕
折篷	摺篷
折紙	摺紙
折裙	摺裙
撒布	撒佈
撚須	撚鬚
擔仔面	擔仔麵
擔擔面	擔擔麵
據雲	據云
擢發难数	擢髮難數
拟準	擬准
摆布	擺佈
摄制	攝製
拐杖	柺杖
拐棍	柺棍
支乾	支幹
收獲	收穫
改制	改製
放松	放鬆
故布疑陣	故佈疑陣
散夥	散伙
散布	散佈
散發	散髮
整只	整隻
整出	整齣
敌忾同雠	敵愾同讎
文借	文藉
文採	文采
鬥亞蘭路	斗亞蘭路
鬥六	斗六
鬥南	斗南
鬥大	斗大
鬥子	斗子
鬥室	斗室
鬥宿	斗宿
鬥方	斗方
鬥栱	斗栱
鬥笠	斗笠
鬥筲	斗筲
鬥箕	斗箕
鬥篷	斗篷
鬥膽	斗膽
鬥蓬	斗蓬
鬥轉參橫	斗轉參橫
鬥量	斗量
鬥門	斗門
料鬥	料斗
斤鬥	斤斗
欲望	慾望
欲念	慾念
禁欲	禁慾
食欲	食慾
情欲	情慾
求知欲	求知慾
欲壑难填	慾壑難填
縱欲	縱慾
六欲	六慾
色欲	色慾
嗜欲	嗜慾
欲障	慾障
欲海	慾海
欲界	慾界
欲心	慾心
欲事	慾事
欲塵	慾塵
欲火	慾火
物欲	物慾
七情六欲	七情六慾
欲壑難填	慾壑難填
利欲熏心	利慾熏心
欲令智昏	慾令智昏
淳朴	淳樸
惇朴	惇樸
簡朴	簡樸
熏黑	燻黑
熏肉	燻肉
煙熏	煙燻
蕎面	蕎麵
扣子	釦子
鈕扣	鈕釦
衣扣	衣釦
袖扣	袖釦
解扣	解釦
新歷	新曆
斷發文身	斷髮文身
方志	方誌
施舍	施捨
旁注	旁註
旅游	旅遊
旋回	旋迴
族里	族裡
日歷	日曆
日志	日誌
日進鬥金	日進斗金
明窗淨幾	明窗淨几
明里	明裡
星鬥	星斗
星歷	星曆
星移鬥換	星移斗換
星移鬥轉	星移斗轉
星羅棋布	星羅棋佈
星辰表	星辰錶
春假里	春假裡
春天里	春天裡
春游	春遊
景致	景緻
暗地里	暗地裡
暗溝里	暗溝裡
暗里	暗裡
暢游	暢遊
暴敛横徵	暴斂橫征
歷數	曆數
歷書	曆書
歷法	曆法
歷象	曆象
會乾	會幹
會里	會裡
月歷	月曆
有只	有隻
木制	木製
朴子	樸子
朴實	樸實
朴忠	樸忠
朴直	樸直
朴硝	樸硝
朴素	樸素
朴茂	樸茂
朴資茅斯	樸資茅斯
朴鈍	樸鈍
朴厚	樸厚
材乾	材幹
村里	村裡
杜老志道	杜老誌道
束修	束脩
束發	束髮
杯面	杯麵
東岳	東嶽
東徵	東征
東游	東遊
松贊乾布	松贊干布
枕借	枕藉
林宏岳	林宏嶽
枝乾	枝幹
某只	某隻
染發	染髮
櫃柳	柜柳
校雠学	校讎學
核準	核准
核復	核覆
格里	格裡
案準	案准
條乾	條幹
梯沖	梯衝
械系	械繫
棉制	棉製
植發	植髮
標致	標緻
標注	標註
標志	標誌
模制	模製
樹乾	樹幹
树乾	樹榦
橫徵暴斂	橫征暴斂
橫沖	橫衝
檢復	檢覆
欄乾	欄干
欷籲	欷吁
欺蒙	欺矇
歌後	歌后
歐游	歐遊
此僕彼起	此仆彼起
武後	武后
歸並	歸併
死里求生	死裡求生
死里逃生	死裡逃生
殼里	殼裡
母後	母后
每只	每隻
比乾	比干
贊揚	讚揚
贊美	讚美
稱贊	稱讚
贊不絕口	讚不絕口
贊佩	讚佩
贊歎	讚歎
贊歎不已	讚嘆不已
像贊	像讚
禮贊	禮讚
贊語	讚語
贊歌	讚歌
贊賞	讚賞
贊許	讚許
贊譽	讚譽
毫發	毫髮
氣沖鬥牛	氣沖斗牛
氣沖牛鬥	氣沖牛斗
水鬥	水斗
水里	水裡
水表	水錶
永歷	永曆
永志不忘	永誌不忘
污蔑	汙衊
江乾	江干
池里	池裡
沒事乾	沒事幹
沒精打採	沒精打采
沙里淘金	沙裡淘金
河岳	河嶽
河里	河裡
油面	油麵
泛游	泛遊
泡制	泡製
泡面	泡麵
泰鬥	泰斗
洄游	洄遊
洗發	洗髮
派團参加	派團參加
浪琴表	浪琴錶
浪游	浪遊
浮夸	浮誇
浮游	浮遊
海里	海裡
液晶表	液晶錶
涼面	涼麵
淡朱	淡硃
淵淳岳峙	淵淳嶽峙
渠沖	渠衝
港制	港製
湖里	湖裡
汤團	湯糰
湯面	湯麵
滷制	滷製
滷面	滷麵
滿布	滿佈
漏鬥	漏斗
漫游	漫遊
潛意識里	潛意識裡
潭里	潭裡
濃發	濃髮
湿地松	濕地鬆
蒙蒙	濛濛
蒙雾	濛霧
蒙鸿	濛鴻
沈海	瀋海
沈陽	瀋陽
彌漫	瀰漫
漓江	灕江
火並	火併
灰蒙	灰濛
炒面	炒麵
炮制	炮製
烏乾達	烏干達
烏發	烏髮
烏龍面	烏龍麵
烘制	烘製
無乾	無干
無精打採	無精打采
煉制	煉製
毛發	毛髮
煙鬥	煙斗
煙鬥絲	煙斗絲
照準	照准
熨鬥	熨斗
燎發	燎髮
燕游	燕遊
燙發	燙髮
燙面	燙麵
爆籲	爆吁
牆里	牆裡
挨餓	捱餓
挨打	捱打
挨罵	捱罵
挨日子	捱日子
三國志	三國誌
片言只語	片言隻語
拌面	拌麵
牛肉面	牛肉麵
牛只	牛隻
特準	特准
特里	特裡
特制	特製
牽系	牽繫
狼借	狼藉
猛沖	猛衝
獎杯	獎盃
獲準	獲准
率團参加	率團參加
王侯後	王侯后
王後	王后
班里	班裡
理發	理髮
環游	環遊
甜面醬	甜麵醬
生力面	生力麵
生姜	生薑
生發	生髮
田里	田裡
由餘	由余
殘余	殘餘
由表及里	由表及裡
男傭	男佣
男用表	男用錶
留發	留髮
畚鬥	畚斗
劃著	畫著
疏松	疏鬆
疑系	疑係
疲困	疲睏
病症	病癥
病愈	病癒
痊愈	痊癒
治愈	治癒
症結	癥結
症瘕	癥瘕
發布	發佈
發蒙	發矇
發面	發麵
發霉	發黴
白乾兒	白干兒
白里透紅	白裡透紅
白發	白髮
白面	白麵
百谷	百穀
百里	百裡
百只	百隻
皇後	皇后
皇歷	皇曆
皓發	皓髮
皮里春秋	皮裡春秋
皮制	皮製
皺折	皺摺
盒里	盒裡
監制	監製
盤里	盤裡
盤回	盤迴
直接参與	直接參与
直沖	直衝
相克	相剋
相乾	相干
相沖	相衝
眼簾	眼帘
眼眶里	眼眶裡
眼里	眼裡
困乏	睏乏
困倦	睏倦
睡游病	睡遊病
了如	瞭如
了望	瞭望
了然	瞭然
了若指掌	瞭若指掌
了解	瞭解
瞳蒙	瞳矇
蒙住	矇住
蒙昧无知	矇昧無知
蒙混	矇混
蒙蒙	矇矇
蒙眬	矇矓
蒙蔽	矇蔽
蒙骗	矇騙
苧麻	苧蔴
矜夸	矜誇
短發	短髮
矮幾	矮几
石英表	石英錶
研制	研製
砰當	砰噹
朱唇皓齿	硃脣皓齒
朱批	硃批
朱砂	硃砂
朱笔	硃筆
朱红色	硃紅色
朱色	硃色
朱谕	硃諭
硬乾	硬幹
碑志	碑誌
磁制	磁製
磨制	磨製
示復	示覆
社里	社裡
神游	神遊
神採	神采
御侮	禦侮
御寇	禦寇
御寒	禦寒
御敵	禦敵
禮義乾櫓	禮義干櫓
禿發	禿髮
秀鬥	秀斗
秀發	秀髮
私下里	私下裡
秋天里	秋天裡
秋裤	秋褲
秋千	鞦韆
秒表	秒錶
稀松	稀鬆
稟復	稟覆
稻谷	稻穀
稽徵	稽征
谷人	穀人
谷保家商	穀保家商
谷倉	穀倉
谷場	穀場
谷子	穀子
谷梁	穀梁
谷殼	穀殼
谷物	穀物
谷皮	穀皮
谷神	穀神
谷谷	穀穀
谷粒	穀粒
谷艙	穀艙
谷苗	穀苗
谷草	穀草
谷賤傷農	穀賤傷農
谷道	穀道
谷雨	穀雨
谷類	穀類
谷風	穀風
积極参與	積极參与
积極参加	積极參加
空蒙	空濛
窗明幾淨	窗明几淨
窩里	窩裡
窮發	窮髮
竹林之游	竹林之遊
笆鬥	笆斗
笑里藏刀	笑裡藏刀
筋鬥	筋斗
答復	答覆
筵幾	筵几
箕鬥	箕斗
算歷	算曆
粗制	粗製
粗滷	粗鹵
精乾	精幹
精明强乾	精明強幹
精致	精緻
精制	精製
精採	精采
糊口	餬口
團子	糰子
系里	系裡
紀歷	紀曆
紅繩系足	紅繩繫足
红發	紅髮
紆回	紆迴
納採	納采
純朴	純樸
素食面	素食麵
素發	素髮
素面	素麵
紫微鬥數	紫微斗數
紫姜	紫薑
細致	細緻
組里	組裡
結伴同游	結伴同遊
結發	結髮
丝布	絲布
丝板	絲板
丝瓜布	絲瓜布
丝绒布	絲絨布
丝線	絲線
丝织廠	絲織廠
丝蟲	絲蟲
維系	維繫
綰發	綰髮
網里	網裡
紧繃	緊繃
編制	編製
編發	編髮
緩沖	緩衝
致密	緻密
縈回	縈迴
縣里	縣裡
縣志	縣誌
縫里	縫裡
縫制	縫製
纖夫	縴夫
纖手	縴手
繁復	繁複
繃带	繃帶
繃紧	繃緊
繃脸	繃臉
繃开	繃開
繪制	繪製
系上	繫上
系世	繫世
系到	繫到
系囚	繫囚
系心	繫心
系念	繫念
系懷	繫懷
系戀	繫戀
系數	繫數
系於	繫於
系系	繫系
系結	繫結
系緊	繫緊
系繩	繫繩
系累	繫纍
系著	繫著
系辭	繫辭
系風捕影	繫風捕影
累囚	纍囚
累累	纍纍
壇子	罈子
壇壇罐罐	罈罈罐罐
骨壇	骨罈
羈系	羈繫
美制	美製
美發	美髮
翱游	翱遊
翻來復去	翻來覆去
翻天復地	翻天覆地
翻復	翻覆
翻雲復雨	翻雲覆雨
老麼	老么
老姜	老薑
老板	老闆
耕獲	耕穫
聊齋志異	聊齋誌異
聯系	聯繫
肉絲面	肉絲麵
肉羹面	肉羹麵
肉松	肉鬆
肚里	肚裡
胃里	胃裡
背地里	背地裡
能乾	能幹
脈沖	脈衝
修脯	脩脯
脫發	脫髮
腦子里	腦子裡
腰里	腰裡
腳注	腳註
膨松	膨鬆
卧游	臥遊
自制	自製
自夸	自誇
舂谷	舂穀
興致	興緻
興高採烈	興高采烈
舊歷	舊曆
舊游	舊遊
航海歷	航海曆
船只	船隻
艦只	艦隻
花盆里	花盆裡
花採	花采
苑里	苑裡
若乾	若干
苦乾	苦幹
苦里	苦裡
苦滷	苦鹵
范圍	範圍
風范	風範
規范	規範
模范	模範
范例	範例
范疇	範疇
示范	示範
師范	師範
懿范	懿範
茶幾	茶几
草叢里	草叢裡
莊里	莊裡
莖乾	莖幹
菌丝體	菌絲體
華里	華裡
華發	華髮
萬歷	萬曆
萬只	萬隻
落發	落髮
蓄發	蓄髮
蓄須	蓄鬚
蓬發	蓬髮
蓬松	蓬鬆
姜末	薑末
姜母	薑母
姜汁	薑汁
姜片	薑片
姜糖	薑糖
姜絲	薑絲
姜茶	薑茶
姜餅	薑餅
姜黃	薑黃
姜湯	薑湯
薙發	薙髮
借以	藉以
借助	藉助
借口	藉口
借故	藉故
借機	藉機
借此	藉此
借由	藉由
借端	藉端
借著	藉著
借借	藉藉
借詞	藉詞
借資	藉資
借酒澆愁	藉酒澆愁
藤制	藤製
蘊借	蘊藉
蘿卜	蘿蔔
虎須	虎鬚
虛夸	虛誇
號志	號誌
蜂後	蜂后
蜜里調油	蜜裡調油
蠁乾	蠁幹
蠻乾	蠻幹
行事歷	行事曆
胡同	衚衕
沖上	衝上
沖下	衝下
沖來	衝來
沖倒	衝倒
沖冠	衝冠
沖出	衝出
沖到	衝到
沖刺	衝刺
沖克	衝剋
沖力	衝力
沖勁	衝勁
沖動	衝動
沖去	衝去
沖口	衝口
沖垮	衝垮
沖堂	衝堂
沖壓	衝壓
沖天	衝天
沖掉	衝掉
沖撞	衝撞
沖擊	衝擊
沖散	衝散
沖決	衝決
沖浪	衝浪
沖激	衝激
沖破	衝破
沖程	衝程
沖突	衝突
沖線	衝線
沖著	衝著
沖沖	衝衝
怒氣衝衝	怒氣沖沖
沖要	衝要
沖起	衝起
沖進	衝進
沖過	衝過
沖鋒	衝鋒
表里	表裡
袋里	袋裡
袖里	袖裡
被里	被裡
被復	被覆
被發	被髮
裁並	裁併
裁制	裁製
補注	補註
里面	裡面
里人	裡人
里加	裡加
里外	裡外
里子	裡子
里屋	裡屋
里層	裡層
里布	裡布
里帶	裡帶
里弦	裡弦
里應外合	裡應外合
里拉	裡拉
里斯	裡斯
里海	裡海
里脊	裡脊
里衣	裡衣
里里	裡裡
里通外國	裡通外國
里通外敵	裡通外敵
里邊	裡邊
里間	裡間
里頭	裡頭
制件	製件
制作	製作
制做	製做
制備	製備
制冰	製冰
制冷	製冷
制劑	製劑
制品	製品
制圖	製圖
制成	製成
制法	製法
制為	製為
制片	製片
制版	製版
制程	製程
制糖	製糖
制纸	製紙
制藥	製藥
制表	製表
制造	製造
制革	製革
制鞋	製鞋
制鹽	製鹽
復仞年如	複仞年如
復以百萬	複以百萬
復信	覆信
復分數	複分數
復列	複列
復利	複利
復印	複印
復句	複句
復合	複合
復名	複名
復壁	複壁
復壯	複壯
復姓	複姓
復字鍵	複字鍵
復審	複審
復寫	複寫
復式	複式
復復	複復
復數	複數
復本	複本
復查	複查
復核	複核
復檢	複檢
復次	複次
復比	複比
復決	複決
復測	複測
復畝珍	複畝珍
復發	複發
復目	複目
復眼	複眼
復種	複種
復線	複線
復習	複習
復興社	複興社
復舊	複舊
復色	複色
復葉	複葉
復蓋	複蓋
復蘇	復甦
蘇醒	甦醒
復制	複製
復診	複診
復評	複評
復詞	複詞
復課	複課
復變函數	複變函數
復賽	複賽
復述	複述
復選	複選
復錢	複錢
復閱	複閱
復雜	複雜
復電	複電
復音	複音
復韻	複韻
喧嘩	喧譁
全體大嘩	全體大譁
嘩眾取寵	譁眾取寵
襯里	襯裡
西岳	西嶽
西徵	西征
西歷	西曆
西游	西遊
要沖	要衝
復上	覆上
復亡	覆亡
復住	覆住
復冒	覆冒
復判	覆判
復命	覆命
復在	覆在
復审	覆審
復写	覆寫
復巢	覆巢
復成	覆成
復敗	覆敗
復文	覆文
復校	覆校
復核	覆核
復水難收	覆水難收
復沒	覆沒
復滅	覆滅
復疊	覆疊
復盆	覆盆
復舟	覆舟
復著	覆著
復蓋	覆蓋
復蓋著	覆蓋著
復試	覆試
復誦	覆誦
復議	覆議
復車	覆車
復載	覆載
復轍	覆轍
復述	覆述
復選	覆選
復電	覆電
復鼎金	覆鼎金
見復	見覆
親徵	親征
角落里	角落裡
觔鬥	觔斗
觸須	觸鬚
訂制	訂製
注上	註上
注冊	註冊
注失	註失
注定	註定
注明	註明
注標	註標
注生娘娘	註生娘娘
注疏	註疏
注腳	註腳
注解	註解
注記	註記
注譯	註譯
注釋	註釋
注銷	註銷
評注	評註
詞匯	詞彙
詞採	詞采
試制	試製
話里有話	話裡有話
詳注	詳註
夸下海口	誇下海口
夸了	誇了
夸來夸去	誇來誇去
夸別	誇別
夸功	誇功
夸口	誇口
夸嘴	誇嘴
夸大	誇大
夸張	誇張
夸得	誇得
夸成	誇成
夸獎	誇獎
夸示	誇示
夸耀	誇耀
夸著	誇著
夸夸	誇誇
夸誕	誇誕
夸贊	誇讚
夸起	誇起
夸過	誇過
夸飾	誇飾
志哀	誌哀
志喜	誌喜
志慶	誌慶
誘奸	誘姦
語雲	語云
語匯	語彙
誣蔑	誣衊
課徵	課征
調制	調製
请参閱	請參閱
谢絕参观	謝絕參觀
譯注	譯註
護發	護髮
雠正	讎正
雠隙	讎隙
豆腐乾	豆腐干
豐富多採	豐富多采
豐滨	豐濱
豐滨乡	豐濱鄉
豐採	豐采
貴乾	貴幹
賈後	賈后
賜復	賜覆
賢後	賢后
質朴	質樸
購並	購併
赤繩系足	赤繩繫足
赤松	赤鬆
起復	起複
超級杯	超級盃
趕制	趕製
跟鬥	跟斗
跳表	跳錶
蹈借	蹈藉
躓僕	躓仆
軀乾	軀幹
車庫里	車庫裡
車站里	車站裡
車里	車裡
輕松	輕鬆
輪奸	輪姦
輪回	輪迴
辛醜	辛丑
辦夥	辦伙
辭匯	辭彙
農歷	農曆
迂回	迂迴
近日里	近日裡
迥然回異	迥然迴異
回光返照	迴光返照
回向	迴向
回圈	迴圈
回廊	迴廊
回形夾	迴形夾
回文	迴文
回旋	迴旋
回流	迴流
回環	迴環
回盪	迴盪
回紋針	迴紋針
回繞	迴繞
回翔	迴翔
回腸	迴腸
回蕩	迴蕩
回誦	迴誦
回路	迴路
回轉	迴轉
回遞性	迴遞性
回避	迴避
回鑾	迴鑾
回音	迴音
回響	迴響
回風	迴風
回首	迴首
迷蒙	迷濛
退夥	退伙
逍遙游	逍遙遊
這里	這裡
這只	這隻
这麼	這麼
通奸	通姦
通心面	通心麵
連系	連繫
游了	遊了
游人	遊人
游仙	遊仙
游伴	遊伴
游俠	遊俠
游冶	遊冶
游動	遊動
游園	遊園
游子	遊子
游學	遊學
游客	遊客
游宦	遊宦
游山玩水	遊山玩水
游必有方	遊必有方
游憩	遊憩
游戲	遊戲
游手好閑	遊手好閒
游手好閒	遊手好閒
游方	遊方
游星	遊星
游樂	遊樂
游標卡尺	遊標卡尺
游歷	遊歷
游民	遊民
游河	遊河
游牧	遊牧
游獵	遊獵
游玩	遊玩
游盪	遊盪
游目騁懷	遊目騁懷
游程	遊程
游絲	遊絲
游興	遊興
游船	遊船
游艇	遊艇
游蕩	遊蕩
游藝	遊藝
游行	遊行
游街	遊街
游覽	遊覽
游記	遊記
游資	遊資
游走	遊走
游蹤	遊蹤
游逛	遊逛
游錯	遊錯
游離	遊離
游騎兵	遊騎兵
游魂	遊魂
遍布	遍佈
遞回	遞迴
遠徵	遠征
遠游	遠遊
遨游	遨遊
遮復	遮覆
還沖	還衝
徑庭	逕庭
大相徑庭	大相逕庭
邋里邋遢	邋裡邋遢
那里	那裡
那只	那隻
郁悶	鬱悶
郁郁	鬱郁
郁金香	鬱金香
憂郁	憂鬱
抑郁	抑鬱
悒郁	悒鬱
郊游	郊遊
鄉里	鄉裡
鄰里	鄰裡
配制	配製
酒杯	酒盃
酒壇	酒罈
酥松	酥鬆
醋壇	醋罈
醞借	醞藉
医藥	醫葯
釀制	釀製
採地	采地
採女	采女
採聲	采聲
採色	采色
採薇	采薇
採薪之憂	采薪之憂
採蘭贈藥	采蘭贈藥
採邑	采邑
採採	采采
採風	采風
里程表	里程錶
重折	重摺
重制	重製
重復	重複
重復	重覆
重游	重遊
野游	野遊
金鬥	金斗
金裝玉里	金裝玉裡
金表	金錶
金發	金髮
銀朱	銀硃
銀發	銀髮
銅制	銅製
鋁制	鋁製
鋼制	鋼製
錄制	錄製
表帶	錶帶
表店	錶店
表廠	錶廠
表殼	錶殼
表鏈	錶鏈
锻鍊出	鍛鍊出
锻鍊身體	鍛鍊身体
鐘子期	鍾子期
鐘山	鍾山
鐘情	鍾情
鐘愛	鍾愛
鐘縣	鍾縣
鐘表	鐘錶
鐘離	鍾離
鐘靈毓秀	鍾靈毓秀
鐘馗	鍾馗
鏽蚀	鏽蝕
長籲短嘆	長吁短歎
長籲短歎	長吁短歎
長徵	長征
長發	長髮
長須鯨	長鬚鯨
門簾	門帘
酒簾	酒帘
門鬥	門斗
門里	門裡
開夥	開伙
開誠布公	開誠佈公
開採	開采
閒情逸致	閒情逸緻
閒游	閒遊
間不容發	間不容髮
閔採爾	閔采爾
暗倫	闇倫
暗冥	闇冥
暗劣	闇劣
暗弱	闇弱
暗然	闇然
昆侖	崑崙
昆侖山	崑崙山
拿破侖	拿破崙
闌乾	闌干
關系	關係
關系著	關係著
防御	防禦
阿鬥	阿斗
阿里	阿裡
附注	附註
除舊布新	除舊佈新
陰乾	陰干
陰歷	陰曆
陸徵祥	陸征祥
陸游	陸遊
陽春面	陽春麵
陽歷	陽曆
只字	隻字
只影	隻影
只手遮天	隻手遮天
只眼	隻眼
只言片語	隻言片語
只身	隻身
雅致	雅緻
集游法	集遊法
雇傭	雇佣
雙折	雙摺
雜志	雜誌
雞奸	雞姦
雞丝	雞絲
雞絲面	雞絲麵
雞腿面	雞腿麵
雞只	雞隻
難舍	難捨
雪里	雪裡
雲游	雲遊
雲須	雲鬚
電子表	電子錶
電沖	電衝
電復	電覆
電表	電錶
霧里	霧裡
靈修	靈脩
青霉	青黴
鞋里	鞋裡
鞣制	鞣製
鞭辟入里	鞭辟入裡
韓國制	韓國製
韓制	韓製
頌系	頌繫
預制	預製
頒布	頒佈
頭里	頭裡
頭發	頭髮
頰須	頰鬚
顛僕	顛仆
顛復	顛覆
風土志	風土誌
風鬥	風斗
風物志	風物誌
風里	風裡
風採	風采
防台	防颱
台風	颱風
刮了	颳了
刮倒	颳倒
刮去	颳去
刮得	颳得
刮著	颳著
刮走	颳走
刮起	颳起
刮風	颳風
刮颱風	颳颱風
飄游	飄遊
飯團	飯糰
饼乾	餅乾
餛飩面	餛飩麵
首當其沖	首當其衝
馬表	馬錶
騰沖	騰衝
骨子里	骨子裡
骨乾	骨幹
骨灰壇	骨灰罈
骯臟	骯髒
臟亂	髒亂
臟了	髒了
臟兮兮	髒兮兮
臟字	髒字
臟得	髒得
臟東西	髒東西
臟水	髒水
臟的	髒的
臟話	髒話
臟錢	髒錢
高乾	高幹
髭須	髭鬚
發型	髮型
發夾	髮夾
發妻	髮妻
發姐	髮姐
發帶	髮帶
發廊	髮廊
發式	髮式
發指	髮指
發卷	髮捲
發根	髮根
發毛	髮毛
發油	髮油
發狀	髮狀
發短心長	髮短心長
發端	髮端
發結	髮結
發絲	髮絲
發網	髮網
發膚	髮膚
發膠	髮膠
發菜	髮菜
發蠟	髮蠟
發辮	髮辮
發針	髮針
發長	髮長
發際	髮際
發雕	髮雕
發霜	髮霜
發髻	髮髻
發鬢	髮鬢
鬅松	鬅鬆
松了	鬆了
松些	鬆些
松勁	鬆勁
松動	鬆動
松口	鬆口
松土	鬆土
松弛	鬆弛
松快	鬆快
松懈	鬆懈
松手	鬆手
松掉	鬆掉
松散	鬆散
松柔	鬆柔
松毛蟲	鬆毛蟲
松浮	鬆浮
松濤	鬆濤
松科	鬆科
松節油	鬆節油
松綁	鬆綁
松緊	鬆緊
松緩	鬆緩
松脆	鬆脆
松脫	鬆脫
松起	鬆起
松軟	鬆軟
松通	鬆通
松開	鬆開
松餅	鬆餅
松松	鬆鬆
鬈發	鬈髮
胡子	鬍子
胡梢	鬍梢
胡渣	鬍渣
胡髭	鬍髭
胡須	鬍鬚
須根	鬚根
須毛	鬚毛
須生	鬚生
須眉	鬚眉
須發	鬚髮
須須	鬚鬚
鬢發	鬢髮
魂牽夢系	魂牽夢繫
魚松	魚鬆
鯨須	鯨鬚
鴻篇巨制	鴻篇巨製
鶴發	鶴髮
滷化	鹵化
滷味	鹵味
滷族	鹵族
滷水	鹵水
滷汁	鹵汁
滷簿	鹵簿
滷素	鹵素
滷莽	鹵莽
滷鈍	鹵鈍
鹹汤	鹹湯
鹹猪肉	鹹豬肉
鹹类	鹹類
鹹鱼	鹹魚
鹹鸭蛋	鹹鴨蛋
鹹滷	鹹鹵
鹹陽	咸陽
鹽滷	鹽鹵
面價	麵價
面包	麵包
面團	麵團
面店	麵店
面廠	麵廠
面攤	麵攤
面杖	麵杖
面條	麵條
面灰	麵灰
面皮	麵皮
面筋	麵筋
面粉	麵粉
面糊	麵糊
面線	麵線
面茶	麵茶
面食	麵食
面餃	麵餃
面餅	麵餅
麻醬面	麻醬麵
熱乾面	熱乾麵
方便面	方便麵
快速面	快速麵
即食面	即食麵
速食面	速食麵
炸醬面	炸醬麵
黃歷	黃曆
黃發	黃髮
黑發	黑髮
黑松	黑鬆
霉毒	黴毒
霉素	黴素
霉菌	黴菌
鼓里	鼓裡
冬冬	鼕鼕
龍鐘	龍鍾
龍須	龍鬚
挽聯	輓聯
挽歌	輓歌
挽額	輓額
挽幛	輓幛
吊唁	弔唁
開吊	開弔
陪吊	陪弔
憑吊	憑弔
吊民伐罪	弔民伐罪
吊奠	弔奠
吊古尋幽	弔古尋幽
吊詭	弔詭
吊喪	弔喪
吊客	弔客
吊問	弔問
吊祭	弔祭
吊孝	弔孝
吊書	弔書
吊詞	弔詞
吊宴	弔宴
吊慰	弔慰
吊文	弔文
會吊	會弔
哀吊	哀弔
逾期	踰期
逾越	踰越
年逾花甲	年踰花甲
蕩檢逾閒	蕩檢踰閒
蕩檢逾閑	蕩檢踰閒
簽子	籤子
牙簽	牙籤
書簽	書籤
標簽	標籤
溜須拍馬	溜鬚拍馬
起哄	起鬨
哄闹	鬨鬧
一哄而散	一鬨而散
不識台舉	不識枱舉
寫字台	寫字枱
彈子台	彈子枱
彈珠台	彈珠枱
撞球台	撞球枱
台子	枱子
台布	枱布
台燈	枱燈
台球	枱球
台面	枱面
窗台	窗枱
賭台	賭枱
辦公台	辦公枱
櫃台	櫃枱
轉台	轉枱
幸免	倖免
僥幸	僥倖
寵幸	寵倖
卷帘格	捲簾格
卷铺盖	捲舖蓋
铺盖卷	舖蓋捲
倒卷	倒捲
自动倒卷	自動倒捲
倒账卷逃	倒賬捲逃
卷逃	捲逃
卷起	捲起
卷起来	捲起來
卷著	捲著
卷入	捲入
卷儿	捲兒
一卷	一捲
卷尺	捲尺
卷帘门	捲簾門
卷曲	捲曲
卷舌	捲舌
卷舌元音	捲舌元音
卷土重来	捲土重來
卷心菜	捲心菜
卷须	捲鬚
卷烟	捲煙
卷扬机	捲揚機
撣掉	撢掉
撣瓶	撢瓶
撣甩子	撢甩子
撣帚	撢帚
撣去灰塵	撢去灰塵
撣子	撢子
雞毛撣子	雞毛撢子
撣衣服	撢衣服
撣桌子	撢桌子
撣一撣	撢一撢
撣土	撢土
撣塵	撢塵
托管	託管
委托	委託
請托	請託
屯扎	屯紮
住扎	住紮
安營扎寨	安營紮寨
穩扎穩打	穩紮穩打
扎實	紮實
扎腳	紮腳
扎寨	紮寨
扎營	紮營
扎根	紮根
扎根基層	紮根基層
飛扎	飛紮
包扎	包紮
捆扎	捆紮
結扎	結紮
綁扎	綁紮
裹扎	裹紮
扎彩	紮彩
扎褲腳	紮褲腳
扎皮帶	紮皮帶
扎染	紮染
扎辮子	紮辮子
扎帶子	紮帶子
扎緊	紮緊
扎腿	紮腿
扎行李	紮行李
扎彩	紮綵
扎彩牌樓	紮彩牌樓
黄曲毒素	黃麴毒素
酒醴曲蘖	酒醴麴櫱
酒曲	酒麴
蘖曲	櫱麴
曲蘖	麴櫱
鋪子	舖子
店鋪	店舖
商鋪	商舖
金鋪	金舖
鐵鋪	鐵舖
雜貨鋪	雜貨舖
肉鋪	肉舖
鋪兒	舖兒
鋪蓋	舖蓋
床鋪	床舖
鋪位	舖位
臥鋪	臥舖
上鋪	上舖
下鋪	下舖
五里鋪	五里舖
十里鋪	十里舖
五金店鋪	五金店舖
吊鋪	吊舖
搬鋪	搬舖
當鋪	當舖
通鋪	通舖
統鋪	統舖
小鋪	小舖
質鋪	質舖
飯鋪	飯舖
藥鋪	藥舖
裁縫鋪	裁縫舖
蠟鋪	蠟舖
果子鋪	果子舖
行鋪	行舖
掛貨鋪	掛貨舖
酒鋪	酒舖
錢鋪	錢舖
香鋪	香舖
香蠟鋪	香蠟舖
中藥鋪	中藥舖
成衣鋪	成衣舖
書鋪	書舖
總鋪	總舖
押鋪	押舖
印鋪	印舖
龍卷風	龍捲風
麻痺	痲痺
麻風	痲風
麻疹	痲疹
䓖	藭
琎	璡
䌺	䋙
䌻	䋚
䌼	綐
䌽	綵
䌾	䋻
䌿	䋹
䍀	繿
鳤	䲘
䜧	䜀
䞌	𧵳
䞍	䝼
䞐	賰
䥺	釾
䥾	䥱
䦂	䥇
䦅	鐥
䦆	钁
䦶	䦛
䦷	䦟
䩄	靦
䭪	糧
䯅	䯀
䲟	鮣
䶮	龑
葚	椹
𫚭	鱲
𪨶	輋
䢀	𨊰
䢁	𨊸
𫄧	綖
𥮾	篸
𬂩	梜
𫛭	鵟
𫖯	頫
𪾢	睍
𬯎	隤
𪣻	塿
𢀖	娙
𢀖	巠
𬩽	鄩
𫶇	嵽
𪩘	巘
𫖮	顗
𫷷	廞
𫸩	彄
𬸦	鷟
𬶨	鱀
𬀪	晛
𬀩	暐
𬃊	櫍
𫚖	鮆
𬍡	璗
𬉼	熰
𬊤	燀
𬊈	燖
𬸚	鸑
𬸘	鶠
𬱟	頠
𫭢	埨
𫭟	塸
𫮃	墠
𫖳	頵
𬷕	鵏
𬱖	頔
𬸪	鷭
𬕂	篢
𪟝	勣
𫐄	軏
𫐐	輗
𫐓	輮
𬨂	軝
𬨎	輶
𬪩	醲
𬮱	闉
𫔶	闑
𫗴	饘
𫗧	餗
𬳵	駓
𬳿	駼
𬳽	駪
𬳶	駉
𫘦	騊
𫘪	騵
𫘝	駃
𫘬	騱
𫘧	騄
𫘜	馼
𫘨	騠
𬴃	騞
𬴊	驎
𬶐	鮡
𬶟	鯻
𬶋	鮈
𬶏	鮠
𬶮	鱚
𬶍	鮀
𫚕	鰤
𬶠	鰊
𬶭	鰶
𬸣	鶱
𬹼	齘
𫠜	齯
𬺈	齮
𬺓	齼
𬇕	澫
𬇹	漍
𬇙	浿
𬍛	瓅
𫢸	僤
𬍤	璕
𬟽	蝀
𫌀	襀
𬣙	訏
𫍲	謏
𫍣	詷
𫍯	諴
𬤇	諲
𬤝	譓
𬣡	諓
𬤊	諟
𫍽	譞
𬣳	詪
𬣞	詝
𬭚	錞
𬬭	錀
𬭤	鍭
𫟹	鉷
𫓹	錤
𬬻	鑪
𬬿	鉊
𫓯	銈
𫓧	鈇
𬭎	鋐
𬬩	釴
𬭬	鏏
𬬱	釿
𬬸	鉥
𬭁	鉧
𬬹	鉮
𫔍	鐇
𫔎	鐍
𬭸	鏻
𬭩	鎓
𫓶	鋗
𬭼	鐩
𬬮	鋹
𬮿	隑
𬯀	隮
𫑡	鄳
𬘯	綧
𫟅	綡
𬘘	紞
𬘡	絪
𬙊	纆
𬘫	綄
𬙂	縯
𬘓	紃
𫄨	絺
𬘩	綎
𫄷	繶
𬘭	綝
𫄸	纁
𬙋	纕
𬘬	綪
𫇭	蒍
𬜬	蔄
𬟁	虉
㤖	懧
𨱇	銶
鹮	䴉
𢫊	𢷮
䓕	薳
蝎	蠍
胄	冑
慭	憖
𫚉	魟
欄桿	欄杆
電線桿	電線杆
拉桿子	拉杆子
桿子頭兒	杆子頭兒
衝壓	沖壓
淒慘	悽慘
淒然	悽然
淒切	悽切
淒愴	悽愴
淒惻	悽惻
悲淒	悲悽
哀淒	哀悽
